EA ./images/Brick_1.xpm




    NO ./images/Brick_2.xpm
      F        220, 30, 10,     

SO ./images/Brick_3.xpm




C +223,+201,+70


WE ./images/Brick_4.xpm


  
      
1111111111111111111111111
1000000000110000000000001
1011000001110000000000001
1001000000000010000000001
1111111110110000011100001000000001
100000000011000001110111111111111
11110111100000000000000010001
1111011111000000110101001000111111111111
1100000011000001110000001000000000000111
100000000000100011000N000000111111111111111
10000000000000000001010010001
110000011101010111110111100111
11110111 1110101 101111010001
11111111 1111111 111111111111
