111111111111111
1000000000000001
1000000000000001
1000000000000001
1000000000000001
1000000000000001
111110000000111
11   1111111