EA ./path_to_the_east_texture




    NO ./path_to_the_north_texture
      F         220,100,0
SO ./path_to_the_south_texture


WE           ./path_to_the_west_texture



C 225,             30,         0


1111111111111111111111111
1000000000110000000000001
1011000001110000000000001
1001000000010000000000001
111111111011000001110000000000001
100000000011000001111111111111111
11110111111111011100000010001
11110111111111011101110010001
110000001101011111000000100011111
1000000000000000110000001000000001
100000000000000000010100000011111
11000001110101011111011110N0111
11110111 1110101 101111010001
11111111 1111111 111111111011
                          1
   
   
                            1
