EA ./images/Brick_9.xpm




    NO ./images/torch_1.xpm
      F        220, 30, 10,

SO ./images/Brick_6.xpm




C +223,+201,+70


WE ./images/Brick_8.xpm
1111111111111111111111111
1000000000110000000000001
1011000001110000000000001
1001000000000100000000001
1111111110110000011100001
100000000011000001110111111111111
110000000000000000000000100001
11000000000000000010100100011111111111
11000000000000000000000000W000D0000000111
100000000000000000000000000111111111111111
10000000000000000001010010001
110000011101010111110111100111
11110111 1110101 101111010001
11111111 1111111 111111111111
