EA ./images/img_test.xpm




    NO ./images/img_test.xpm
      F        220, 00, 00,     

SO ./images/img_test.xpm




C +223,+201,+70


WE ./images/img_test.xpm


  
      
1111111111111111111111111
1000000000110000000000001
1011000001110000000000001
1001000000000010000000001
1111111110110000011100001000000001
100000000011000001110111111111111
11110111100000000000000010001
11110111110000001101010010001
11000000110000011100000010001
100000000000100011000N0000001
10000000000000000001010010001
110000011101010111110111100111
11110111 1110101 101111010001
11111111 1111111 111111111111
 
  
   
    
 
  
   
    
 
  
   
    
   
    
 
  
   
    
 
  
   
11111
101
111